,date,control_point,in_hk,in_mainland,in_other,in_total,out_hk,out_mainland,out_other,out_total
0,1 January 2022,Airport,609,3,16,628,720,14,44,778
1,1 January 2022,Hong Kong-Zhuhai-Macao Bridge,67,4,7,78,219,13,2,234
2,1 January 2022,Shenzhen Bay,495,126,6,627,892,109,2,1003
3,2 January 2022,Airport,958,15,7,980,1543,62,94,1699
4,2 January 2022,Hong Kong-Zhuhai-Macao Bridge,119,10,14,143,225,14,7,246
5,2 January 2022,Shenzhen Bay,785,133,15,933,960,137,2,1099
6,3 January 2022,Airport,756,12,5,773,1024,26,38,1088
7,3 January 2022,Hong Kong-Zhuhai-Macao Bridge,80,13,13,106,257,17,2,276
8,3 January 2022,Shenzhen Bay,724,95,12,831,1224,146,4,1374
9,4 January 2022,Airport,554,15,25,594,1287,27,44,1358
10,4 January 2022,Hong Kong-Zhuhai-Macao Bridge,70,8,11,89,238,24,7,269
11,4 January 2022,Shenzhen Bay,644,116,5,765,1096,136,7,1239
12,5 January 2022,Airport,729,15,16,760,1028,36,58,1122
13,5 January 2022,Hong Kong-Zhuhai-Macao Bridge,90,9,11,110,228,12,5,245
14,5 January 2022,Shenzhen Bay,756,108,16,880,1078,151,6,1235
15,6 January 2022,Airport,682,10,15,707,989,17,53,1059
16,6 January 2022,Hong Kong-Zhuhai-Macao Bridge,77,5,11,93,227,16,4,247
17,6 January 2022,Shenzhen Bay,771,137,14,922,1080,157,1,1238
18,7 January 2022,Airport,344,11,33,388,1963,62,78,2103
19,7 January 2022,Hong Kong-Zhuhai-Macao Bridge,95,2,15,112,273,12,9,294
20,7 January 2022,Shenzhen Bay,879,155,19,1053,1134,152,6,1292
21,8 January 2022,Airport,782,10,12,804,1308,63,53,1424
22,8 January 2022,Hong Kong-Zhuhai-Macao Bridge,124,13,4,141,297,9,20,326
23,8 January 2022,Shenzhen Bay,844,157,17,1018,1139,152,1,1292
24,9 January 2022,Airport,683,20,3,706,1798,48,97,1943
25,9 January 2022,Hong Kong-Zhuhai-Macao Bridge,136,12,9,157,272,11,10,293
26,9 January 2022,Shenzhen Bay,934,201,12,1147,1000,97,3,1100
27,10 January 2022,Airport,174,14,7,195,1059,55,40,1154
28,10 January 2022,Hong Kong-Zhuhai-Macao Bridge,115,11,14,140,257,13,8,278
29,10 January 2022,Shenzhen Bay,760,107,5,872,936,104,1,1041
30,11 January 2022,Airport,150,12,3,165,1056,47,39,1142
31,11 January 2022,Hong Kong-Zhuhai-Macao Bridge,102,14,20,136,214,12,12,238
32,11 January 2022,Shenzhen Bay,797,128,9,934,958,120,4,1082
33,12 January 2022,Airport,620,14,13,647,1156,38,45,1239
34,12 January 2022,Hong Kong-Zhuhai-Macao Bridge,170,26,4,200,240,18,3,261
35,12 January 2022,Shenzhen Bay,858,153,9,1020,1055,137,2,1194
36,13 January 2022,Airport,175,28,10,213,716,17,29,762
37,13 January 2022,Hong Kong-Zhuhai-Macao Bridge,175,17,5,197,241,17,3,261
38,13 January 2022,Shenzhen Bay,888,184,11,1083,1217,168,2,1387
39,14 January 2022,Airport,560,23,34,617,1512,35,51,1598
40,14 January 2022,Hong Kong-Zhuhai-Macao Bridge,225,15,11,251,227,10,4,241
41,14 January 2022,Shenzhen Bay,980,156,14,1150,1133,224,9,1366
42,15 January 2022,Airport,535,20,20,575,1125,32,57,1214
43,15 January 2022,Hong Kong-Zhuhai-Macao Bridge,214,26,17,257,196,12,8,216
44,15 January 2022,Shenzhen Bay,1197,184,19,1400,1087,200,1,1288
45,16 January 2022,Airport,894,24,14,932,1379,35,72,1486
46,16 January 2022,Hong Kong-Zhuhai-Macao Bridge,150,11,7,168,198,16,13,227
47,16 January 2022,Shenzhen Bay,1037,223,7,1267,981,162,2,1145
48,17 January 2022,Airport,268,10,9,287,873,21,51,945
49,17 January 2022,Hong Kong-Zhuhai-Macao Bridge,150,12,14,176,217,13,4,234
50,17 January 2022,Shenzhen Bay,812,110,8,930,885,158,4,1047
51,18 January 2022,Airport,139,8,17,164,955,27,37,1019
52,18 January 2022,Hong Kong-Zhuhai-Macao Bridge,71,0,3,74,64,0,5,69
53,18 January 2022,Shenzhen Bay,985,163,5,1153,834,134,0,968
54,19 January 2022,Airport,398,19,19,436,1094,15,40,1149
55,19 January 2022,Hong Kong-Zhuhai-Macao Bridge,54,0,9,63,26,0,10,36
56,19 January 2022,Shenzhen Bay,1019,156,6,1181,771,130,5,906
57,20 January 2022,Airport,248,18,25,291,503,19,24,546
58,20 January 2022,Hong Kong-Zhuhai-Macao Bridge,54,1,5,60,33,0,10,43
59,20 January 2022,Shenzhen Bay,1299,223,5,1527,698,98,2,798
60,21 January 2022,Airport,539,20,5,564,1278,24,44,1346
61,21 January 2022,Hong Kong-Zhuhai-Macao Bridge,82,0,10,92,57,0,14,71
62,21 January 2022,Shenzhen Bay,1602,188,7,1797,977,182,5,1164
63,22 January 2022,Airport,416,19,12,447,753,17,21,791
64,22 January 2022,Hong Kong-Zhuhai-Macao Bridge,46,0,5,51,52,0,6,58
65,22 January 2022,Shenzhen Bay,1619,242,12,1873,1037,172,7,1216
66,23 January 2022,Airport,618,24,25,667,1715,36,54,1805
67,23 January 2022,Hong Kong-Zhuhai-Macao Bridge,40,0,4,44,53,0,8,61
68,23 January 2022,Shenzhen Bay,1246,206,7,1459,827,151,3,981
69,24 January 2022,Airport,349,16,12,377,783,24,40,847
70,24 January 2022,Hong Kong-Zhuhai-Macao Bridge,37,0,7,44,45,0,5,50
71,24 January 2022,Shenzhen Bay,860,132,5,997,867,144,1,1012
72,25 January 2022,Airport,206,3,13,222,868,12,26,906
73,25 January 2022,Hong Kong-Zhuhai-Macao Bridge,40,0,10,50,64,0,11,75
74,25 January 2022,Shenzhen Bay,1339,148,12,1499,833,137,4,974
75,26 January 2022,Airport,678,7,21,706,1119,20,34,1173
76,26 January 2022,Hong Kong-Zhuhai-Macao Bridge,54,0,7,61,44,0,3,47
77,26 January 2022,Shenzhen Bay,1495,174,7,1676,714,132,5,851
78,27 January 2022,Airport,389,9,13,411,514,11,32,557
79,27 January 2022,Hong Kong-Zhuhai-Macao Bridge,69,0,12,81,36,0,6,42
80,27 January 2022,Shenzhen Bay,1397,191,4,1592,645,100,10,755
81,28 January 2022,Airport,508,12,13,533,1092,13,36,1141
82,28 January 2022,Hong Kong-Zhuhai-Macao Bridge,139,0,14,153,34,0,7,41
83,28 January 2022,Shenzhen Bay,1440,188,10,1638,664,120,5,789
84,29 January 2022,Airport,426,13,12,451,610,12,29,651
85,29 January 2022,Hong Kong-Zhuhai-Macao Bridge,93,0,15,108,25,0,3,28
86,29 January 2022,Shenzhen Bay,907,179,8,1094,824,103,3,930
87,30 January 2022,Airport,508,16,11,535,1442,15,50,1507
88,30 January 2022,Hong Kong-Zhuhai-Macao Bridge,41,1,10,52,33,0,3,36
89,30 January 2022,Shenzhen Bay,723,134,6,863,804,125,2,931
90,31 January 2022,Airport,87,1,12,100,564,1,24,589
91,31 January 2022,Hong Kong-Zhuhai-Macao Bridge,51,8,8,67,19,0,2,21
92,31 January 2022,Shenzhen Bay,237,49,12,298,782,96,3,881
93,1 February 2022,Airport,152,2,7,161,580,22,14,616
94,1 February 2022,Hong Kong-Zhuhai-Macao Bridge,18,7,10,35,32,0,7,39
95,1 February 2022,Shenzhen Bay,65,21,0,86,823,122,1,946
96,2 February 2022,Airport,401,3,24,428,951,19,38,1008
97,2 February 2022,Hong Kong-Zhuhai-Macao Bridge,30,2,5,37,33,0,1,34
98,2 February 2022,Shenzhen Bay,192,42,3,237,933,177,2,1112
99,3 February 2022,Airport,170,2,9,181,874,16,31,921
100,3 February 2022,Hong Kong-Zhuhai-Macao Bridge,39,5,7,51,32,0,2,34
101,3 February 2022,Shenzhen Bay,350,46,6,402,1039,185,2,1226
102,4 February 2022,Airport,126,8,6,140,1032,13,28,1073
103,4 February 2022,Hong Kong-Zhuhai-Macao Bridge,35,2,10,47,60,0,8,68
104,4 February 2022,Shenzhen Bay,404,89,4,497,1164,239,6,1409
105,5 February 2022,Airport,352,7,5,364,1316,29,24,1369
106,5 February 2022,Hong Kong-Zhuhai-Macao Bridge,75,6,7,88,53,1,3,57
107,5 February 2022,Shenzhen Bay,446,80,3,529,1142,261,6,1409
108,6 February 2022,Airport,971,14,30,1015,1944,55,61,2060
109,6 February 2022,Hong Kong-Zhuhai-Macao Bridge,90,10,13,113,49,0,3,52
110,6 February 2022,Shenzhen Bay,934,88,0,1022,1243,275,8,1526
111,7 February 2022,Airport,463,3,23,489,889,23,33,945
112,7 February 2022,Hong Kong-Zhuhai-Macao Bridge,57,1,5,63,73,0,5,78
113,7 February 2022,Shenzhen Bay,509,65,2,576,1326,245,1,1572
114,8 February 2022,Airport,155,8,6,169,1175,41,39,1255
115,8 February 2022,Hong Kong-Zhuhai-Macao Bridge,62,4,10,76,45,0,4,49
116,8 February 2022,Shenzhen Bay,541,56,4,601,1790,376,4,2170
117,9 February 2022,Airport,689,2,16,707,1336,30,36,1402
118,9 February 2022,Hong Kong-Zhuhai-Macao Bridge,71,2,6,79,41,0,5,46
119,9 February 2022,Shenzhen Bay,381,47,2,430,1790,349,2,2141
120,10 February 2022,Airport,494,3,28,525,1168,38,50,1256
121,10 February 2022,Hong Kong-Zhuhai-Macao Bridge,67,3,8,78,35,0,3,38
122,10 February 2022,Shenzhen Bay,418,62,4,484,1276,195,2,1473
123,11 February 2022,Airport,456,3,18,477,1457,51,39,1547
124,11 February 2022,Hong Kong-Zhuhai-Macao Bridge,44,4,5,53,37,0,0,37
125,11 February 2022,Shenzhen Bay,295,28,0,323,1046,159,4,1209
126,12 February 2022,Airport,239,8,13,260,1869,35,41,1945
127,12 February 2022,Hong Kong-Zhuhai-Macao Bridge,48,4,10,62,288,34,3,325
128,12 February 2022,Shenzhen Bay,360,49,4,413,956,91,3,1050
129,13 February 2022,Airport,533,3,15,551,2954,95,53,3102
130,13 February 2022,Hong Kong-Zhuhai-Macao Bridge,86,3,5,94,345,24,3,372
131,13 February 2022,Shenzhen Bay,556,55,6,617,835,76,1,912
132,14 February 2022,Airport,299,3,15,317,1771,84,10,1865
133,14 February 2022,Hong Kong-Zhuhai-Macao Bridge,39,1,3,43,389,28,4,421
134,14 February 2022,Shenzhen Bay,341,31,0,372,840,78,0,918
135,15 February 2022,Airport,291,1,8,300,2283,87,31,2401
136,15 February 2022,Hong Kong-Zhuhai-Macao Bridge,34,3,3,40,407,40,4,451
137,15 February 2022,Shenzhen Bay,456,23,4,483,800,83,3,886
138,16 February 2022,Airport,513,3,20,536,2647,115,52,2814
139,16 February 2022,Hong Kong-Zhuhai-Macao Bridge,68,3,18,89,391,39,1,431
140,16 February 2022,Shenzhen Bay,496,32,1,529,851,83,2,936
141,17 February 2022,Airport,227,8,11,246,2292,120,38,2450
142,17 February 2022,Hong Kong-Zhuhai-Macao Bridge,39,1,3,43,405,31,1,437
143,17 February 2022,Shenzhen Bay,293,46,3,342,839,98,6,943
144,18 February 2022,Airport,318,4,11,333,2113,99,33,2245
145,18 February 2022,Hong Kong-Zhuhai-Macao Bridge,46,4,16,66,363,29,8,400
146,18 February 2022,Shenzhen Bay,236,30,3,269,800,115,2,917
147,19 February 2022,Airport,384,4,5,393,2801,167,26,2994
148,19 February 2022,Hong Kong-Zhuhai-Macao Bridge,28,2,8,38,371,26,3,400
149,19 February 2022,Shenzhen Bay,370,42,1,413,737,114,0,851
150,20 February 2022,Airport,303,3,10,316,3172,113,47,3332
151,20 February 2022,Hong Kong-Zhuhai-Macao Bridge,43,4,8,55,365,29,4,398
152,20 February 2022,Shenzhen Bay,349,30,3,382,699,114,0,813
153,21 February 2022,Airport,165,2,8,175,2245,103,33,2381
154,21 February 2022,Hong Kong-Zhuhai-Macao Bridge,15,1,10,26,346,30,1,377
155,21 February 2022,Shenzhen Bay,190,27,2,219,682,122,2,806
156,22 February 2022,Airport,229,3,2,234,2702,142,31,2875
157,22 February 2022,Hong Kong-Zhuhai-Macao Bridge,34,1,5,40,371,36,7,414
158,22 February 2022,Shenzhen Bay,179,26,1,206,658,109,1,768
159,23 February 2022,Airport,589,3,18,610,2419,127,33,2579
160,23 February 2022,Hong Kong-Zhuhai-Macao Bridge,31,2,6,39,369,41,2,412
161,23 February 2022,Shenzhen Bay,204,12,3,219,653,103,1,757
162,24 February 2022,Airport,171,0,12,183,1944,100,31,2075
163,24 February 2022,Hong Kong-Zhuhai-Macao Bridge,24,0,8,32,348,34,6,388
164,24 February 2022,Shenzhen Bay,151,59,0,210,794,124,3,921
165,25 February 2022,Airport,143,3,9,155,2071,96,18,2185
166,25 February 2022,Hong Kong-Zhuhai-Macao Bridge,23,6,0,29,292,46,0,338
167,25 February 2022,Shenzhen Bay,181,49,4,234,706,113,2,821
168,26 February 2022,Airport,451,2,3,456,2422,69,21,2512
169,26 February 2022,Hong Kong-Zhuhai-Macao Bridge,24,3,2,29,345,35,0,380
170,26 February 2022,Shenzhen Bay,168,16,3,187,684,96,0,780
171,27 February 2022,Airport,413,1,8,422,2893,140,26,3059
172,27 February 2022,Hong Kong-Zhuhai-Macao Bridge,32,2,2,36,313,29,1,343
173,27 February 2022,Shenzhen Bay,219,51,3,273,716,116,2,834
174,28 February 2022,Airport,175,1,0,176,1626,72,15,1713
175,28 February 2022,Hong Kong-Zhuhai-Macao Bridge,36,1,4,41,275,37,0,312
176,28 February 2022,Shenzhen Bay,255,29,1,285,703,114,2,819
177,1 March 2022,Airport,207,0,2,209,2558,81,27,2666
178,1 March 2022,Hong Kong-Zhuhai-Macao Bridge,14,4,5,23,277,23,2,302
179,1 March 2022,Shenzhen Bay,173,30,6,209,661,100,2,763
180,2 March 2022,Airport,532,3,21,556,3228,115,45,3388
181,2 March 2022,Hong Kong-Zhuhai-Macao Bridge,15,3,3,21,297,32,3,332
182,2 March 2022,Shenzhen Bay,181,12,0,193,656,88,0,744
183,3 March 2022,Airport,369,1,25,395,2249,70,50,2369
184,3 March 2022,Hong Kong-Zhuhai-Macao Bridge,14,2,2,18,262,27,1,290
185,3 March 2022,Shenzhen Bay,115,14,0,129,624,94,1,719
186,4 March 2022,Airport,165,4,2,171,2929,108,39,3076
187,4 March 2022,Hong Kong-Zhuhai-Macao Bridge,12,3,1,16,242,40,0,282
188,4 March 2022,Shenzhen Bay,113,76,1,190,463,71,1,535
189,5 March 2022,Airport,229,6,11,246,2477,84,22,2583
190,5 March 2022,Hong Kong-Zhuhai-Macao Bridge,26,0,3,29,231,30,0,261
191,5 March 2022,Shenzhen Bay,86,17,0,103,486,82,2,570
192,6 March 2022,Airport,615,4,11,630,4092,101,45,4238
193,6 March 2022,Hong Kong-Zhuhai-Macao Bridge,31,3,5,39,254,34,0,288
194,6 March 2022,Shenzhen Bay,142,19,1,162,492,64,0,556
195,7 March 2022,Airport,204,1,10,215,1522,26,28,1576
196,7 March 2022,Hong Kong-Zhuhai-Macao Bridge,18,1,3,22,194,22,1,217
197,7 March 2022,Shenzhen Bay,125,7,0,132,431,55,1,487
198,8 March 2022,Airport,109,0,5,114,1989,30,18,2037
199,8 March 2022,Hong Kong-Zhuhai-Macao Bridge,15,5,5,25,183,18,5,206
200,8 March 2022,Shenzhen Bay,102,15,5,122,416,80,0,496
201,9 March 2022,Airport,401,4,15,420,3394,64,57,3515
202,9 March 2022,Hong Kong-Zhuhai-Macao Bridge,25,0,7,32,187,17,0,204
203,9 March 2022,Shenzhen Bay,101,10,0,111,462,56,0,518
204,10 March 2022,Airport,274,0,14,288,2216,76,42,2334
205,10 March 2022,Hong Kong-Zhuhai-Macao Bridge,17,0,1,18,176,23,0,199
206,10 March 2022,Shenzhen Bay,116,11,2,129,434,70,0,504
207,11 March 2022,Airport,276,2,14,292,2217,36,46,2299
208,11 March 2022,Hong Kong-Zhuhai-Macao Bridge,17,2,4,23,179,19,1,199
209,11 March 2022,Shenzhen Bay,209,39,1,249,462,63,0,525
210,12 March 2022,Airport,168,4,2,174,1910,16,37,1963
211,12 March 2022,Hong Kong-Zhuhai-Macao Bridge,22,1,6,29,170,20,3,193
212,12 March 2022,Shenzhen Bay,82,15,1,98,431,75,2,508
213,13 March 2022,Airport,181,0,9,190,2629,24,40,2693
214,13 March 2022,Hong Kong-Zhuhai-Macao Bridge,34,3,1,38,192,23,3,218
215,13 March 2022,Shenzhen Bay,205,19,0,224,461,59,0,520
216,14 March 2022,Airport,97,2,9,108,1635,29,29,1693
217,14 March 2022,Hong Kong-Zhuhai-Macao Bridge,19,0,3,22,186,15,3,204
218,14 March 2022,Shenzhen Bay,186,48,1,235,436,55,1,492
219,15 March 2022,Airport,397,1,5,403,1970,45,30,2045
220,15 March 2022,Hong Kong-Zhuhai-Macao Bridge,42,5,7,54,185,21,0,206
221,15 March 2022,Shenzhen Bay,178,17,4,199,434,58,0,492
222,16 March 2022,Airport,468,5,9,482,2580,49,38,2667
223,16 March 2022,Hong Kong-Zhuhai-Macao Bridge,32,4,1,37,188,21,1,210
224,16 March 2022,Shenzhen Bay,93,10,1,104,448,49,3,500
225,17 March 2022,Airport,148,2,5,155,1761,39,28,1828
226,17 March 2022,Hong Kong-Zhuhai-Macao Bridge,36,3,0,39,162,13,0,175
227,17 March 2022,Shenzhen Bay,38,8,1,47,409,82,0,491
228,18 March 2022,Airport,439,1,17,457,1785,33,36,1854
229,18 March 2022,Hong Kong-Zhuhai-Macao Bridge,36,5,5,46,159,23,0,182
230,18 March 2022,Shenzhen Bay,176,20,1,197,389,74,0,463
231,19 March 2022,Airport,526,2,19,547,1665,31,30,1726
232,19 March 2022,Hong Kong-Zhuhai-Macao Bridge,46,12,5,63,184,17,3,204
233,19 March 2022,Shenzhen Bay,34,13,0,47,355,53,1,409
234,20 March 2022,Airport,275,2,5,282,2197,38,50,2285
235,20 March 2022,Hong Kong-Zhuhai-Macao Bridge,64,14,3,81,170,9,2,181
236,20 March 2022,Shenzhen Bay,65,7,0,72,344,57,1,402
237,21 March 2022,Airport,171,1,5,177,927,37,25,989
238,21 March 2022,Hong Kong-Zhuhai-Macao Bridge,32,2,2,36,146,14,2,162
239,21 March 2022,Shenzhen Bay,83,12,2,97,166,27,0,193
240,22 March 2022,Airport,93,0,2,95,1086,25,17,1128
241,22 March 2022,Hong Kong-Zhuhai-Macao Bridge,46,3,4,53,169,17,0,186
242,22 March 2022,Shenzhen Bay,267,20,3,290,164,25,0,189
243,23 March 2022,Airport,332,3,6,341,1679,52,31,1762
244,23 March 2022,Hong Kong-Zhuhai-Macao Bridge,52,2,0,54,160,17,2,179
245,23 March 2022,Shenzhen Bay,318,12,1,331,174,29,2,205
246,24 March 2022,Airport,136,1,10,147,1905,52,13,1970
247,24 March 2022,Hong Kong-Zhuhai-Macao Bridge,29,1,1,31,143,19,5,167
248,24 March 2022,Shenzhen Bay,165,10,1,176,253,38,2,293
249,25 March 2022,Airport,166,1,8,175,2037,41,37,2115
250,25 March 2022,Hong Kong-Zhuhai-Macao Bridge,42,2,9,53,159,24,2,185
251,25 March 2022,Shenzhen Bay,359,27,3,389,209,37,0,246
252,26 March 2022,Airport,316,2,4,322,1675,27,21,1723
253,26 March 2022,Hong Kong-Zhuhai-Macao Bridge,39,3,4,46,174,20,1,195
254,26 March 2022,Shenzhen Bay,166,63,0,229,192,71,0,263
255,27 March 2022,Airport,662,4,5,671,2212,43,32,2287
256,27 March 2022,Hong Kong-Zhuhai-Macao Bridge,58,11,2,71,147,17,5,169
257,27 March 2022,Shenzhen Bay,246,15,3,264,181,30,0,211
258,28 March 2022,Airport,113,2,6,121,925,23,17,965
259,28 March 2022,Hong Kong-Zhuhai-Macao Bridge,43,3,4,50,180,17,2,199
260,28 March 2022,Shenzhen Bay,252,50,0,302,217,55,0,272
261,29 March 2022,Airport,66,0,0,66,1795,20,22,1837
262,29 March 2022,Hong Kong-Zhuhai-Macao Bridge,50,9,3,62,167,18,0,185
263,29 March 2022,Shenzhen Bay,296,32,1,329,170,23,0,193
264,30 March 2022,Airport,162,5,7,174,1886,37,22,1945
265,30 March 2022,Hong Kong-Zhuhai-Macao Bridge,72,3,1,76,160,15,4,179
266,30 March 2022,Shenzhen Bay,319,16,1,336,158,29,1,188
267,31 March 2022,Airport,273,18,9,300,1384,42,85,1511
268,31 March 2022,Hong Kong-Zhuhai-Macao Bridge,73,3,0,76,153,16,2,171
269,31 March 2022,Shenzhen Bay,453,20,1,474,192,27,0,219
270,1 April 2022,Airport,1928,7,27,1962,2777,44,32,2853
271,1 April 2022,Hong Kong-Zhuhai-Macao Bridge,32,6,14,52,134,20,0,154
272,1 April 2022,Shenzhen Bay,250,48,1,299,211,104,0,315
273,2 April 2022,Airport,1206,2,13,1221,2211,22,35,2268
274,2 April 2022,Hong Kong-Zhuhai-Macao Bridge,50,7,7,64,163,14,3,180
275,2 April 2022,Shenzhen Bay,274,34,1,309,252,57,0,309
276,3 April 2022,Airport,942,11,12,965,2206,28,25,2259
277,3 April 2022,Hong Kong-Zhuhai-Macao Bridge,81,19,0,100,168,14,2,184
278,3 April 2022,Shenzhen Bay,335,28,2,365,351,52,1,404
279,4 April 2022,Airport,819,14,14,847,1987,30,26,2043
280,4 April 2022,Hong Kong-Zhuhai-Macao Bridge,31,5,5,41,175,18,0,193
281,4 April 2022,Shenzhen Bay,286,49,1,336,287,61,0,348
282,5 April 2022,Airport,1152,2,12,1166,1233,15,13,1261
283,5 April 2022,Hong Kong-Zhuhai-Macao Bridge,54,5,4,63,182,24,0,206
284,5 April 2022,Shenzhen Bay,271,61,3,335,310,56,3,369
285,6 April 2022,Airport,815,5,16,836,1656,29,29,1714
286,6 April 2022,Hong Kong-Zhuhai-Macao Bridge,74,4,4,82,176,28,0,204
287,6 April 2022,Shenzhen Bay,576,70,1,647,295,62,0,357
288,7 April 2022,Airport,624,31,13,668,1652,48,32,1732
289,7 April 2022,Hong Kong-Zhuhai-Macao Bridge,55,11,5,71,150,23,6,179
290,7 April 2022,Shenzhen Bay,637,60,4,701,247,51,2,300
291,8 April 2022,Airport,927,13,13,953,2419,23,46,2488
292,8 April 2022,Hong Kong-Zhuhai-Macao Bridge,58,5,7,70,175,25,0,200
293,8 April 2022,Shenzhen Bay,634,71,5,710,289,68,0,357
294,9 April 2022,Airport,1346,3,13,1362,1827,19,39,1885
295,9 April 2022,Hong Kong-Zhuhai-Macao Bridge,58,7,8,73,164,21,0,185
296,9 April 2022,Shenzhen Bay,506,51,4,561,333,47,1,381
297,10 April 2022,Airport,1264,6,18,1288,1640,20,29,1689
298,10 April 2022,Hong Kong-Zhuhai-Macao Bridge,96,6,3,105,156,17,0,173
299,10 April 2022,Shenzhen Bay,906,60,2,968,272,36,1,309
300,11 April 2022,Airport,1199,3,17,1219,1438,17,18,1473
301,11 April 2022,Hong Kong-Zhuhai-Macao Bridge,72,2,3,77,120,8,1,129
302,11 April 2022,Shenzhen Bay,559,62,8,629,308,59,1,368
303,12 April 2022,Airport,1100,4,7,1111,1539,20,24,1583
304,12 April 2022,Hong Kong-Zhuhai-Macao Bridge,51,11,12,74,137,15,2,154
305,12 April 2022,Shenzhen Bay,508,43,2,553,320,73,0,393
306,13 April 2022,Airport,1946,5,26,1977,1476,50,21,1547
307,13 April 2022,Hong Kong-Zhuhai-Macao Bridge,68,3,1,72,159,16,3,178
308,13 April 2022,Shenzhen Bay,532,46,4,582,300,74,1,375
309,14 April 2022,Airport,1002,5,16,1023,1699,24,25,1748
310,14 April 2022,Hong Kong-Zhuhai-Macao Bridge,47,5,4,56,130,12,3,145
311,14 April 2022,Shenzhen Bay,530,42,5,577,320,61,1,382
312,15 April 2022,Airport,1167,8,10,1185,2140,33,24,2197
313,15 April 2022,Hong Kong-Zhuhai-Macao Bridge,81,10,4,95,128,26,0,154
314,15 April 2022,Shenzhen Bay,653,58,3,714,324,70,2,396
315,16 April 2022,Airport,1497,4,5,1506,1315,29,20,1364
316,16 April 2022,Hong Kong-Zhuhai-Macao Bridge,57,5,4,66,144,11,2,157
317,16 April 2022,Shenzhen Bay,574,61,2,637,328,72,1,401
318,17 April 2022,Airport,1071,3,24,1098,1391,31,32,1454
319,17 April 2022,Hong Kong-Zhuhai-Macao Bridge,119,2,5,126,142,16,2,160
320,17 April 2022,Shenzhen Bay,963,62,1,1026,319,64,0,383
321,18 April 2022,Airport,969,8,11,988,1611,26,18,1655
322,18 April 2022,Hong Kong-Zhuhai-Macao Bridge,138,10,4,152,173,32,0,205
323,18 April 2022,Shenzhen Bay,1087,75,3,1165,368,60,1,429
324,19 April 2022,Airport,1251,0,8,1259,978,16,21,1015
325,19 April 2022,Hong Kong-Zhuhai-Macao Bridge,109,5,3,117,153,29,2,184
326,19 April 2022,Shenzhen Bay,1011,76,0,1087,331,64,3,398
327,20 April 2022,Airport,1587,6,16,1609,1698,46,42,1786
328,20 April 2022,Hong Kong-Zhuhai-Macao Bridge,101,6,6,113,164,19,2,185
329,20 April 2022,Shenzhen Bay,1101,70,7,1178,291,59,0,350
330,21 April 2022,Airport,1903,13,12,1928,1408,49,23,1480
331,21 April 2022,Hong Kong-Zhuhai-Macao Bridge,57,1,10,68,167,10,1,178
332,21 April 2022,Shenzhen Bay,606,69,3,678,291,67,2,360
333,22 April 2022,Airport,1819,17,18,1854,1679,27,28,1734
334,22 April 2022,Hong Kong-Zhuhai-Macao Bridge,94,9,6,109,168,24,0,192
335,22 April 2022,Shenzhen Bay,736,74,2,812,306,54,0,360
336,23 April 2022,Airport,1969,11,24,2004,1334,10,20,1364
337,23 April 2022,Hong Kong-Zhuhai-Macao Bridge,129,7,14,150,148,23,0,171
338,23 April 2022,Shenzhen Bay,1131,113,4,1248,301,113,1,415
339,24 April 2022,Airport,1529,10,11,1550,1749,11,51,1811
340,24 April 2022,Hong Kong-Zhuhai-Macao Bridge,148,6,7,161,160,13,2,175
341,24 April 2022,Shenzhen Bay,1560,119,5,1684,327,69,1,397
342,25 April 2022,Airport,910,19,9,938,1321,19,29,1369
343,25 April 2022,Hong Kong-Zhuhai-Macao Bridge,90,7,7,104,155,14,3,172
344,25 April 2022,Shenzhen Bay,823,119,3,945,388,66,0,454
345,26 April 2022,Airport,1123,8,4,1135,1389,14,37,1440
346,26 April 2022,Hong Kong-Zhuhai-Macao Bridge,91,6,5,102,172,15,0,187
347,26 April 2022,Shenzhen Bay,810,91,7,908,305,46,1,352
348,27 April 2022,Airport,1652,19,14,1685,2368,45,49,2462
349,27 April 2022,Hong Kong-Zhuhai-Macao Bridge,102,3,5,110,154,17,0,171
350,27 April 2022,Shenzhen Bay,788,93,10,891,364,61,2,427
351,28 April 2022,Airport,2176,14,16,2206,1433,32,29,1494
352,28 April 2022,Hong Kong-Zhuhai-Macao Bridge,69,9,3,81,141,22,0,163
353,28 April 2022,Shenzhen Bay,913,99,4,1016,622,69,4,695
354,29 April 2022,Airport,2122,12,32,2166,1948,28,44,2020
355,29 April 2022,Hong Kong-Zhuhai-Macao Bridge,109,6,7,122,147,14,2,163
356,29 April 2022,Shenzhen Bay,1045,105,2,1152,444,86,2,532
357,30 April 2022,Airport,2876,13,32,2921,2325,18,42,2385
358,30 April 2022,Hong Kong-Zhuhai-Macao Bridge,126,11,8,145,115,14,1,130
359,30 April 2022,Shenzhen Bay,1558,154,6,1718,485,76,2,563
360,1 May 2022,Airport,1845,9,52,1906,2437,15,45,2497
361,1 May 2022,Hong Kong-Zhuhai-Macao Bridge,194,12,7,213,152,11,1,164
362,1 May 2022,Shenzhen Bay,2515,310,7,2832,411,72,1,484
363,2 May 2022,Airport,1416,13,47,1476,1386,26,14,1426
364,2 May 2022,Hong Kong-Zhuhai-Macao Bridge,236,19,1,256,117,11,1,129
365,2 May 2022,Shenzhen Bay,2443,280,6,2729,449,81,3,533
366,3 May 2022,Airport,1306,14,65,1385,1373,27,19,1419
367,3 May 2022,Hong Kong-Zhuhai-Macao Bridge,82,8,13,103,126,25,2,153
368,3 May 2022,Shenzhen Bay,911,110,6,1027,383,77,3,463
369,4 May 2022,Airport,1490,19,84,1593,1583,24,20,1627
370,4 May 2022,Hong Kong-Zhuhai-Macao Bridge,74,5,7,86,139,14,2,155
371,4 May 2022,Shenzhen Bay,804,82,7,893,424,91,0,515
372,5 May 2022,Airport,1521,21,52,1594,1986,68,36,2090
373,5 May 2022,Hong Kong-Zhuhai-Macao Bridge,74,17,11,102,135,19,2,156
374,5 May 2022,Shenzhen Bay,899,99,5,1003,720,94,2,816
375,6 May 2022,Airport,1735,19,112,1866,2075,46,22,2143
376,6 May 2022,Hong Kong-Zhuhai-Macao Bridge,111,12,13,136,126,22,0,148
377,6 May 2022,Shenzhen Bay,895,112,4,1011,532,94,1,627
378,7 May 2022,Airport,2419,10,100,2529,2237,23,33,2293
379,7 May 2022,Hong Kong-Zhuhai-Macao Bridge,105,10,13,128,122,20,2,144
380,7 May 2022,Shenzhen Bay,1188,166,7,1361,568,128,1,697
381,8 May 2022,Airport,3034,31,98,3163,2262,58,40,2360
382,8 May 2022,Hong Kong-Zhuhai-Macao Bridge,163,15,7,185,143,10,4,157
383,8 May 2022,Shenzhen Bay,2031,270,1,2302,505,105,2,612
384,9 May 2022,Airport,1651,27,77,1755,1440,16,28,1484
385,9 May 2022,Hong Kong-Zhuhai-Macao Bridge,157,11,7,175,139,22,0,161
386,9 May 2022,Shenzhen Bay,1984,227,2,2213,533,127,1,661
387,10 May 2022,Airport,1702,25,51,1778,1772,57,44,1873
388,10 May 2022,Hong Kong-Zhuhai-Macao Bridge,100,13,15,128,158,16,2,176
389,10 May 2022,Shenzhen Bay,1174,169,7,1350,604,86,1,691
390,11 May 2022,Airport,1653,36,102,1791,1391,107,42,1540
391,11 May 2022,Hong Kong-Zhuhai-Macao Bridge,67,18,14,99,73,1,3,77
392,11 May 2022,Shenzhen Bay,771,149,32,952,538,102,5,645
393,12 May 2022,Airport,1575,45,90,1710,2001,140,68,2209
394,12 May 2022,Hong Kong-Zhuhai-Macao Bridge,63,8,15,86,24,0,8,32
395,12 May 2022,Shenzhen Bay,744,188,39,971,570,108,0,678
396,13 May 2022,Airport,1829,86,135,2050,1949,61,53,2063
397,13 May 2022,Hong Kong-Zhuhai-Macao Bridge,56,5,15,76,30,0,2,32
398,13 May 2022,Shenzhen Bay,712,120,23,855,578,150,2,730
399,14 May 2022,Airport,1769,91,113,1973,2023,22,53,2098
400,14 May 2022,Hong Kong-Zhuhai-Macao Bridge,101,11,18,130,150,23,6,179
401,14 May 2022,Shenzhen Bay,1261,189,4,1454,548,85,9,642
402,15 May 2022,Airport,3263,193,149,3605,2449,69,54,2572
403,15 May 2022,Hong Kong-Zhuhai-Macao Bridge,140,13,9,162,144,21,2,167
404,15 May 2022,Shenzhen Bay,1648,217,5,1870,543,114,1,658
405,16 May 2022,Airport,1993,185,123,2301,2325,34,48,2407
406,16 May 2022,Hong Kong-Zhuhai-Macao Bridge,70,13,10,93,148,18,2,168
407,16 May 2022,Shenzhen Bay,873,111,8,992,584,112,4,700
408,17 May 2022,Airport,1555,212,75,1842,1201,39,32,1272
409,17 May 2022,Hong Kong-Zhuhai-Macao Bridge,76,10,13,99,147,13,6,166
410,17 May 2022,Shenzhen Bay,1029,154,6,1189,598,96,6,700
411,18 May 2022,Airport,1663,354,104,2121,1723,38,66,1827
412,18 May 2022,Hong Kong-Zhuhai-Macao Bridge,84,14,11,109,159,14,2,175
413,18 May 2022,Shenzhen Bay,911,131,3,1045,600,91,6,697
414,19 May 2022,Airport,2154,623,141,2918,1784,60,57,1901
415,19 May 2022,Hong Kong-Zhuhai-Macao Bridge,83,1,16,100,160,28,2,190
416,19 May 2022,Shenzhen Bay,747,107,5,859,563,92,5,660
417,20 May 2022,Airport,1767,430,126,2323,2160,126,52,2338
418,20 May 2022,Hong Kong-Zhuhai-Macao Bridge,94,10,11,115,173,17,4,194
419,20 May 2022,Shenzhen Bay,967,169,10,1146,591,113,6,710
420,21 May 2022,Airport,1784,368,103,2255,2018,12,46,2076
421,21 May 2022,Hong Kong-Zhuhai-Macao Bridge,73,3,13,89,141,28,4,173
422,21 May 2022,Shenzhen Bay,1055,163,12,1230,618,140,9,767
423,22 May 2022,Airport,2652,476,130,3258,2587,104,76,2767
424,22 May 2022,Hong Kong-Zhuhai-Macao Bridge,100,8,13,121,139,22,0,161
425,22 May 2022,Shenzhen Bay,1192,162,6,1360,481,162,7,650
426,23 May 2022,Airport,1866,495,150,2511,1712,138,46,1896
427,23 May 2022,Hong Kong-Zhuhai-Macao Bridge,87,6,13,106,134,21,2,157
428,23 May 2022,Shenzhen Bay,833,99,6,938,539,115,7,661
429,24 May 2022,Airport,1488,364,63,1915,1631,138,45,1814
430,24 May 2022,Hong Kong-Zhuhai-Macao Bridge,72,5,9,86,137,26,4,167
431,24 May 2022,Shenzhen Bay,706,95,6,807,547,143,7,697
432,25 May 2022,Airport,1817,971,131,2919,1566,198,62,1826
433,25 May 2022,Hong Kong-Zhuhai-Macao Bridge,82,3,7,92,141,17,3,161
434,25 May 2022,Shenzhen Bay,806,100,5,911,538,233,8,779
435,26 May 2022,Airport,1931,470,168,2569,2170,269,87,2526
436,26 May 2022,Hong Kong-Zhuhai-Macao Bridge,75,4,10,89,129,63,1,193
437,26 May 2022,Shenzhen Bay,799,100,4,903,429,288,9,726
438,27 May 2022,Airport,1953,739,139,2831,2125,233,77,2435
439,27 May 2022,Hong Kong-Zhuhai-Macao Bridge,91,10,7,108,155,28,4,187
440,27 May 2022,Shenzhen Bay,780,114,9,903,428,303,12,743
441,28 May 2022,Airport,1662,432,113,2207,2304,49,82,2435
442,28 May 2022,Hong Kong-Zhuhai-Macao Bridge,103,12,23,138,151,26,4,181
443,28 May 2022,Shenzhen Bay,1104,151,5,1260,533,268,11,812
444,29 May 2022,Airport,2863,1056,238,4157,2595,194,71,2860
445,29 May 2022,Hong Kong-Zhuhai-Macao Bridge,125,7,20,152,99,60,7,166
446,29 May 2022,Shenzhen Bay,1337,219,10,1566,435,390,13,838
447,30 May 2022,Airport,1348,540,64,1952,1992,304,94,2390
448,30 May 2022,Hong Kong-Zhuhai-Macao Bridge,73,4,7,84,107,37,5,149
449,30 May 2022,Shenzhen Bay,802,106,8,916,463,289,16,768
450,31 May 2022,Airport,1559,477,62,2098,2228,181,98,2507
451,31 May 2022,Hong Kong-Zhuhai-Macao Bridge,92,9,27,128,133,39,4,176
452,31 May 2022,Shenzhen Bay,835,114,3,952,459,255,8,722
453,1 June 2022,Airport,2590,1048,163,3801,2433,338,102,2873
454,1 June 2022,Hong Kong-Zhuhai-Macao Bridge,84,3,17,104,134,108,2,244
455,1 June 2022,Shenzhen Bay,682,99,6,787,475,387,8,870
456,2 June 2022,Airport,2205,825,144,3174,2755,239,88,3082
457,2 June 2022,Hong Kong-Zhuhai-Macao Bridge,76,6,18,100,132,53,7,192
458,2 June 2022,Shenzhen Bay,638,95,7,740,435,335,5,775
459,3 June 2022,Airport,2098,967,161,3226,2589,201,97,2887
460,3 June 2022,Hong Kong-Zhuhai-Macao Bridge,66,7,17,90,118,110,2,230
461,3 June 2022,Shenzhen Bay,545,103,2,650,425,307,14,746
462,4 June 2022,Airport,2070,526,149,2745,2205,17,94,2316
463,4 June 2022,Hong Kong-Zhuhai-Macao Bridge,79,7,18,104,136,54,5,195
464,4 June 2022,Shenzhen Bay,1006,203,5,1214,531,417,9,957
465,5 June 2022,Airport,2753,1189,188,4130,3442,328,113,3883
466,5 June 2022,Hong Kong-Zhuhai-Macao Bridge,134,8,29,171,126,88,5,219
467,5 June 2022,Shenzhen Bay,1533,248,8,1789,316,479,23,818
468,6 June 2022,Airport,1611,936,134,2681,1696,270,60,2026
469,6 June 2022,Hong Kong-Zhuhai-Macao Bridge,67,8,12,87,130,59,13,202
470,6 June 2022,Shenzhen Bay,1024,106,4,1134,481,435,18,934
471,7 June 2022,Airport,1528,630,86,2244,2378,229,86,2693
472,7 June 2022,Hong Kong-Zhuhai-Macao Bridge,77,11,18,106,136,59,5,200
473,7 June 2022,Shenzhen Bay,793,114,6,913,478,489,14,981
474,8 June 2022,Airport,2563,1087,142,3792,2875,352,110,3337
475,8 June 2022,Hong Kong-Zhuhai-Macao Bridge,81,8,15,104,128,94,4,226
476,8 June 2022,Shenzhen Bay,940,109,8,1057,536,458,9,1003
477,9 June 2022,Airport,1578,726,152,2456,2447,377,107,2931
478,9 June 2022,Hong Kong-Zhuhai-Macao Bridge,63,4,15,82,152,59,3,214
479,9 June 2022,Shenzhen Bay,749,106,10,865,607,487,15,1109
480,10 June 2022,Airport,2534,1232,186,3952,2782,425,100,3307
481,10 June 2022,Hong Kong-Zhuhai-Macao Bridge,83,9,14,106,136,99,7,242
482,10 June 2022,Shenzhen Bay,876,130,7,1013,491,490,7,988
483,11 June 2022,Airport,2988,854,184,4026,2800,26,99,2925
484,11 June 2022,Hong Kong-Zhuhai-Macao Bridge,85,8,9,102,145,96,3,244
485,11 June 2022,Shenzhen Bay,1015,333,4,1352,648,500,11,1159
486,12 June 2022,Airport,3089,1025,192,4306,2723,375,105,3203
487,12 June 2022,Hong Kong-Zhuhai-Macao Bridge,114,8,10,132,120,85,10,215
488,12 June 2022,Shenzhen Bay,1063,192,12,1267,477,511,15,1003
489,13 June 2022,Airport,1320,809,99,2228,2385,450,125,2960
490,13 June 2022,Hong Kong-Zhuhai-Macao Bridge,74,4,24,102,135,96,2,233
491,13 June 2022,Shenzhen Bay,779,126,5,910,432,488,22,942
492,14 June 2022,Airport,1805,796,110,2711,2380,348,96,2824
493,14 June 2022,Hong Kong-Zhuhai-Macao Bridge,53,11,20,84,129,68,12,209
494,14 June 2022,Shenzhen Bay,748,113,16,877,483,399,14,896
495,15 June 2022,Airport,1927,1416,149,3492,2811,545,137,3493
496,15 June 2022,Hong Kong-Zhuhai-Macao Bridge,104,9,25,138,190,113,9,312
497,15 June 2022,Shenzhen Bay,881,116,15,1012,524,463,16,1003
498,16 June 2022,Airport,2192,1044,170,3406,2750,337,133,3220
499,16 June 2022,Hong Kong-Zhuhai-Macao Bridge,71,11,12,94,171,73,8,252
500,16 June 2022,Shenzhen Bay,616,126,8,750,464,467,19,950
501,17 June 2022,Airport,2578,1333,172,4083,3098,343,105,3546
502,17 June 2022,Hong Kong-Zhuhai-Macao Bridge,99,7,14,120,140,126,19,285
503,17 June 2022,Shenzhen Bay,704,344,5,1053,479,532,15,1026
504,18 June 2022,Airport,2814,1019,151,3984,4135,156,137,4428
505,18 June 2022,Hong Kong-Zhuhai-Macao Bridge,77,9,31,117,180,77,10,267
506,18 June 2022,Shenzhen Bay,855,205,16,1076,634,316,10,960
507,19 June 2022,Airport,2823,1351,154,4328,3817,448,125,4390
508,19 June 2022,Hong Kong-Zhuhai-Macao Bridge,113,12,24,149,173,107,14,294
509,19 June 2022,Shenzhen Bay,952,175,5,1132,398,529,20,947
510,20 June 2022,Airport,1698,1087,132,2917,2497,279,117,2893
511,20 June 2022,Hong Kong-Zhuhai-Macao Bridge,124,16,41,181,144,118,12,274
512,20 June 2022,Shenzhen Bay,820,130,10,960,392,546,15,953
513,21 June 2022,Airport,2275,949,195,3419,3214,462,127,3803
514,21 June 2022,Hong Kong-Zhuhai-Macao Bridge,91,11,26,128,83,29,2,114
515,21 June 2022,Shenzhen Bay,720,115,10,845,597,514,11,1122
516,22 June 2022,Airport,1979,1099,117,3195,2730,383,100,3213
517,22 June 2022,Hong Kong-Zhuhai-Macao Bridge,83,3,26,112,125,129,11,265
518,22 June 2022,Shenzhen Bay,726,106,8,840,316,439,2,757
519,23 June 2022,Airport,2643,1012,179,3834,3623,528,151,4302
520,23 June 2022,Hong Kong-Zhuhai-Macao Bridge,85,7,30,122,154,120,4,278
521,23 June 2022,Shenzhen Bay,836,113,6,955,409,455,16,880
522,24 June 2022,Airport,2578,1193,168,3939,4147,249,118,4514
523,24 June 2022,Hong Kong-Zhuhai-Macao Bridge,77,9,24,110,111,154,7,272
524,24 June 2022,Shenzhen Bay,696,118,8,822,510,410,14,934
525,25 June 2022,Airport,2596,1088,131,3815,4781,114,129,5024
526,25 June 2022,Hong Kong-Zhuhai-Macao Bridge,72,5,38,115,157,108,10,275
527,25 June 2022,Shenzhen Bay,1055,185,8,1248,404,456,13,873
528,26 June 2022,Airport,3073,1081,143,4297,4268,512,138,4918
529,26 June 2022,Hong Kong-Zhuhai-Macao Bridge,125,15,28,168,125,128,4,257
530,26 June 2022,Shenzhen Bay,1093,270,13,1376,374,425,14,813
531,27 June 2022,Airport,1830,1033,133,2996,2908,570,98,3576
532,27 June 2022,Hong Kong-Zhuhai-Macao Bridge,87,7,29,123,111,125,8,244
533,27 June 2022,Shenzhen Bay,753,115,2,870,347,595,19,961
534,28 June 2022,Airport,2256,772,89,3117,4754,353,127,5234
535,28 June 2022,Hong Kong-Zhuhai-Macao Bridge,122,11,31,164,122,188,5,315
536,28 June 2022,Shenzhen Bay,839,132,10,981,415,698,23,1136
537,29 June 2022,Airport,1837,1131,112,3080,3781,490,155,4426
538,29 June 2022,Hong Kong-Zhuhai-Macao Bridge,108,6,28,142,134,192,3,329
539,29 June 2022,Shenzhen Bay,847,128,18,993,490,607,16,1113
540,30 June 2022,Airport,2192,964,150,3306,4398,473,121,4992
541,30 June 2022,Hong Kong-Zhuhai-Macao Bridge,150,10,37,197,174,139,14,327
542,30 June 2022,Shenzhen Bay,1019,145,15,1179,540,646,18,1204
543,1 July 2022,Airport,3056,1193,167,4416,4944,726,133,5803
544,1 July 2022,Hong Kong-Zhuhai-Macao Bridge,106,9,36,151,170,159,9,338
545,1 July 2022,Shenzhen Bay,685,106,10,801,710,725,10,1445
546,2 July 2022,Airport,2881,779,129,3789,4132,515,211,4858
547,2 July 2022,Hong Kong-Zhuhai-Macao Bridge,4,0,1,5,51,57,3,111
548,2 July 2022,Shenzhen Bay,758,241,91,1090,725,800,23,1548
549,3 July 2022,Airport,3660,903,186,4749,5140,471,199,5810
550,3 July 2022,Hong Kong-Zhuhai-Macao Bridge,145,13,36,194,121,204,3,328
551,3 July 2022,Shenzhen Bay,1301,155,30,1486,492,688,20,1200
552,4 July 2022,Airport,2100,1154,136,3390,2561,384,121,3066
553,4 July 2022,Hong Kong-Zhuhai-Macao Bridge,143,16,38,197,242,87,10,339
554,4 July 2022,Shenzhen Bay,940,109,33,1082,545,775,13,1333
555,5 July 2022,Airport,2179,641,81,2901,3569,366,187,4122
556,5 July 2022,Hong Kong-Zhuhai-Macao Bridge,151,20,53,224,133,123,5,261
557,5 July 2022,Shenzhen Bay,1052,145,29,1226,638,719,13,1370
558,6 July 2022,Airport,1923,1151,149,3223,2587,497,160,3244
559,6 July 2022,Hong Kong-Zhuhai-Macao Bridge,181,17,47,245,116,135,10,261
560,6 July 2022,Shenzhen Bay,1114,150,29,1293,933,482,9,1424
561,7 July 2022,Airport,1851,646,115,2612,2719,457,134,3310
562,7 July 2022,Hong Kong-Zhuhai-Macao Bridge,158,15,35,208,151,126,4,281
563,7 July 2022,Shenzhen Bay,1051,114,12,1177,853,608,16,1477
564,8 July 2022,Airport,2887,1000,203,4090,4263,546,171,4980
565,8 July 2022,Hong Kong-Zhuhai-Macao Bridge,151,15,62,228,178,143,9,330
566,8 July 2022,Shenzhen Bay,1145,187,12,1344,1129,717,11,1857
567,9 July 2022,Airport,2478,1060,207,3745,3697,545,223,4465
568,9 July 2022,Hong Kong-Zhuhai-Macao Bridge,132,13,97,242,163,111,7,281
569,9 July 2022,Shenzhen Bay,1033,214,23,1270,1013,758,21,1792
570,10 July 2022,Airport,4025,1252,238,5515,4032,419,168,4619
571,10 July 2022,Hong Kong-Zhuhai-Macao Bridge,243,19,46,308,190,101,6,297
572,10 July 2022,Shenzhen Bay,1544,296,28,1868,1058,834,17,1909
573,11 July 2022,Airport,2369,1149,175,3693,2104,500,135,2739
574,11 July 2022,Hong Kong-Zhuhai-Macao Bridge,131,25,46,202,145,98,10,253
575,11 July 2022,Shenzhen Bay,965,165,25,1155,1114,683,10,1807
576,12 July 2022,Airport,2602,1087,170,3859,3230,595,180,4005
577,12 July 2022,Hong Kong-Zhuhai-Macao Bridge,151,18,47,216,141,79,2,222
578,12 July 2022,Shenzhen Bay,1165,177,29,1371,1265,714,25,2004
579,13 July 2022,Airport,2044,1262,165,3471,2412,408,132,2952
580,13 July 2022,Hong Kong-Zhuhai-Macao Bridge,151,12,42,205,125,113,8,246
581,13 July 2022,Shenzhen Bay,1100,176,28,1304,1059,728,16,1803
582,14 July 2022,Airport,2112,922,163,3197,2940,529,143,3612
583,14 July 2022,Hong Kong-Zhuhai-Macao Bridge,151,27,50,228,127,94,6,227
584,14 July 2022,Shenzhen Bay,946,160,20,1126,1302,564,16,1882
585,15 July 2022,Airport,2878,1437,225,4540,4080,599,185,4864
586,15 July 2022,Hong Kong-Zhuhai-Macao Bridge,131,8,58,197,108,64,6,178
587,15 July 2022,Shenzhen Bay,1200,205,34,1439,1268,642,18,1928
588,16 July 2022,Airport,2402,1070,164,3636,3574,685,275,4534
589,16 July 2022,Hong Kong-Zhuhai-Macao Bridge,104,9,78,191,64,33,3,100
590,16 July 2022,Shenzhen Bay,1082,258,39,1379,1549,407,8,1964
591,17 July 2022,Airport,4006,1073,191,5270,3976,609,187,4772
592,17 July 2022,Hong Kong-Zhuhai-Macao Bridge,133,25,37,195,48,45,8,101
593,17 July 2022,Shenzhen Bay,1362,240,44,1646,1577,401,11,1989
594,18 July 2022,Airport,2475,1305,154,3934,2069,429,145,2643
595,18 July 2022,Hong Kong-Zhuhai-Macao Bridge,139,8,33,180,103,29,12,144
596,18 July 2022,Shenzhen Bay,994,145,23,1162,1626,446,18,2090
597,19 July 2022,Airport,2409,1015,178,3602,2945,660,151,3756
598,19 July 2022,Hong Kong-Zhuhai-Macao Bridge,86,6,35,127,85,46,0,131
599,19 July 2022,Shenzhen Bay,1052,216,29,1297,1658,410,16,2084
600,20 July 2022,Airport,2278,1209,174,3661,2379,763,179,3321
601,20 July 2022,Hong Kong-Zhuhai-Macao Bridge,114,12,48,174,116,32,8,156
602,20 July 2022,Shenzhen Bay,1400,235,34,1669,1765,478,15,2258
603,21 July 2022,Airport,2337,977,137,3451,2498,847,162,3507
604,21 July 2022,Hong Kong-Zhuhai-Macao Bridge,79,12,55,146,89,33,4,126
605,21 July 2022,Shenzhen Bay,1010,188,16,1214,1644,406,8,2058
606,22 July 2022,Airport,3080,1134,196,4410,3757,1135,190,5082
607,22 July 2022,Hong Kong-Zhuhai-Macao Bridge,107,16,37,160,106,31,9,146
608,22 July 2022,Shenzhen Bay,1055,160,27,1242,1711,449,17,2177
609,23 July 2022,Airport,2894,969,117,3980,3460,781,238,4479
610,23 July 2022,Hong Kong-Zhuhai-Macao Bridge,76,13,73,162,138,82,1,221
611,23 July 2022,Shenzhen Bay,1063,189,31,1283,1758,435,16,2209
612,24 July 2022,Airport,4883,1109,216,6208,3641,950,201,4792
613,24 July 2022,Hong Kong-Zhuhai-Macao Bridge,107,8,53,168,140,92,13,245
614,24 July 2022,Shenzhen Bay,1321,241,34,1596,1631,433,16,2080
615,25 July 2022,Airport,3100,1394,173,4667,2046,801,162,3009
616,25 July 2022,Hong Kong-Zhuhai-Macao Bridge,97,16,20,133,121,92,8,221
617,25 July 2022,Shenzhen Bay,1238,240,30,1508,1704,515,12,2231
618,26 July 2022,Airport,2539,1130,155,3824,2591,744,177,3512
619,26 July 2022,Hong Kong-Zhuhai-Macao Bridge,100,4,27,131,146,84,13,243
620,26 July 2022,Shenzhen Bay,962,177,38,1177,1670,449,14,2133
621,27 July 2022,Airport,2369,1228,207,3804,2311,822,142,3275
622,27 July 2022,Hong Kong-Zhuhai-Macao Bridge,98,8,31,137,159,84,9,252
623,27 July 2022,Shenzhen Bay,1026,161,26,1213,1637,535,19,2191
624,28 July 2022,Airport,2343,1090,157,3590,2793,740,180,3713
625,28 July 2022,Hong Kong-Zhuhai-Macao Bridge,103,11,29,143,141,77,14,232
626,28 July 2022,Shenzhen Bay,1189,220,29,1438,1685,453,14,2152
627,29 July 2022,Airport,2710,1216,176,4102,3884,992,199,5075
628,29 July 2022,Hong Kong-Zhuhai-Macao Bridge,118,7,39,164,145,69,18,232
629,29 July 2022,Shenzhen Bay,1150,162,31,1343,1644,469,19,2132
630,30 July 2022,Airport,2751,1020,189,3960,3808,889,314,5011
631,30 July 2022,Hong Kong-Zhuhai-Macao Bridge,123,12,91,226,185,55,16,256
632,30 July 2022,Shenzhen Bay,1300,207,26,1533,1703,499,19,2221
633,31 July 2022,Airport,3998,1033,158,5189,4269,967,222,5458
634,31 July 2022,Hong Kong-Zhuhai-Macao Bridge,154,12,39,205,153,63,14,230
635,31 July 2022,Shenzhen Bay,1671,225,45,1941,1629,471,15,2115
636,1 August 2022,Airport,4229,1225,276,5730,2647,685,142,3474
637,1 August 2022,Hong Kong-Zhuhai-Macao Bridge,114,19,25,158,202,141,14,357
638,1 August 2022,Shenzhen Bay,1181,145,39,1365,1627,425,24,2076
639,2 August 2022,Airport,3537,729,187,4453,3420,813,166,4399
640,2 August 2022,Hong Kong-Zhuhai-Macao Bridge,102,17,27,146,238,123,12,373
641,2 August 2022,Shenzhen Bay,1095,182,7,1284,1633,455,14,2102
642,3 August 2022,Airport,3388,1240,205,4833,2700,623,199,3522
643,3 August 2022,Hong Kong-Zhuhai-Macao Bridge,113,10,39,162,256,143,14,413
644,3 August 2022,Shenzhen Bay,1263,165,23,1451,1854,446,21,2321
645,4 August 2022,Airport,2898,833,162,3893,3040,865,214,4119
646,4 August 2022,Hong Kong-Zhuhai-Macao Bridge,116,11,30,157,234,128,12,374
647,4 August 2022,Shenzhen Bay,943,138,20,1101,1640,407,11,2058
648,5 August 2022,Airport,3646,1167,238,5051,3875,948,203,5026
649,5 August 2022,Hong Kong-Zhuhai-Macao Bridge,121,21,30,172,244,111,14,369
650,5 August 2022,Shenzhen Bay,1314,202,23,1539,1804,447,24,2275
651,6 August 2022,Airport,3363,975,172,4510,3632,828,266,4726
652,6 August 2022,Hong Kong-Zhuhai-Macao Bridge,129,24,82,235,286,131,18,435
653,6 August 2022,Shenzhen Bay,1352,271,24,1647,1872,490,15,2377
654,7 August 2022,Airport,5064,806,217,6087,4150,871,205,5226
655,7 August 2022,Hong Kong-Zhuhai-Macao Bridge,164,17,26,207,235,139,14,388
656,7 August 2022,Shenzhen Bay,1584,215,20,1819,1747,401,16,2164
657,8 August 2022,Airport,3962,1203,238,5403,2501,805,170,3476
658,8 August 2022,Hong Kong-Zhuhai-Macao Bridge,114,19,28,161,249,158,15,422
659,8 August 2022,Shenzhen Bay,1253,154,23,1430,1687,451,17,2155
660,9 August 2022,Airport,3783,1096,234,5113,3356,704,247,4307
661,9 August 2022,Hong Kong-Zhuhai-Macao Bridge,136,21,35,192,257,156,9,422
662,9 August 2022,Shenzhen Bay,1515,204,16,1735,1822,479,6,2307
663,10 August 2022,Airport,2824,1037,202,4063,2927,808,230,3965
664,10 August 2022,Hong Kong-Zhuhai-Macao Bridge,128,18,22,168,315,104,14,433
665,10 August 2022,Shenzhen Bay,1635,464,79,2178,1822,392,26,2240
666,11 August 2022,Airport,3284,1176,244,4704,3274,963,232,4469
667,11 August 2022,Hong Kong-Zhuhai-Macao Bridge,109,14,30,153,283,134,24,441
668,11 August 2022,Shenzhen Bay,1222,172,24,1418,1653,383,21,2057
669,12 August 2022,Airport,4351,1516,290,6157,4180,984,252,5416
670,12 August 2022,Hong Kong-Zhuhai-Macao Bridge,162,14,28,204,316,92,21,429
671,12 August 2022,Shenzhen Bay,1517,203,27,1747,1781,428,28,2237
672,13 August 2022,Airport,3422,1136,227,4785,3595,822,344,4761
673,13 August 2022,Hong Kong-Zhuhai-Macao Bridge,182,15,99,296,323,87,7,417
674,13 August 2022,Shenzhen Bay,1958,283,28,2269,1912,411,14,2337
675,14 August 2022,Airport,5840,1264,324,7428,4488,970,237,5695
676,14 August 2022,Hong Kong-Zhuhai-Macao Bridge,219,22,45,286,302,117,16,435
677,14 August 2022,Shenzhen Bay,2378,288,18,2684,1725,397,23,2145
678,15 August 2022,Airport,4107,1257,280,5644,2494,555,168,3217
679,15 August 2022,Hong Kong-Zhuhai-Macao Bridge,253,17,26,296,282,130,13,425
680,15 August 2022,Shenzhen Bay,2730,214,37,2981,1838,446,22,2306
681,16 August 2022,Airport,4742,1079,328,6149,3389,496,188,4073
682,16 August 2022,Hong Kong-Zhuhai-Macao Bridge,241,18,33,292,252,150,20,422
683,16 August 2022,Shenzhen Bay,2251,254,21,2526,1759,423,30,2212
684,17 August 2022,Airport,3584,1459,308,5351,2868,677,238,3783
685,17 August 2022,Hong Kong-Zhuhai-Macao Bridge,196,19,38,253,261,146,25,432
686,17 August 2022,Shenzhen Bay,1989,200,26,2215,1827,548,28,2403
687,18 August 2022,Airport,4356,1136,351,5843,3715,960,230,4905
688,18 August 2022,Hong Kong-Zhuhai-Macao Bridge,258,20,28,306,274,140,6,420
689,18 August 2022,Shenzhen Bay,2490,266,11,2767,1638,477,34,2149
690,19 August 2022,Airport,4343,1327,362,6032,3957,1163,263,5383
691,19 August 2022,Hong Kong-Zhuhai-Macao Bridge,219,27,23,269,270,153,10,433
692,19 August 2022,Shenzhen Bay,2354,281,17,2652,1570,557,24,2151
693,20 August 2022,Airport,4218,1160,301,5679,4120,781,404,5305
694,20 August 2022,Hong Kong-Zhuhai-Macao Bridge,346,35,97,478,277,109,24,410
695,20 August 2022,Shenzhen Bay,3220,266,22,3508,1681,590,36,2307
696,21 August 2022,Airport,6214,1382,367,7963,4233,914,270,5417
697,21 August 2022,Hong Kong-Zhuhai-Macao Bridge,400,27,23,450,252,135,19,406
698,21 August 2022,Shenzhen Bay,3849,261,16,4126,1489,595,28,2112
699,22 August 2022,Airport,4154,1196,333,5683,2562,698,206,3466
700,22 August 2022,Hong Kong-Zhuhai-Macao Bridge,308,30,24,362,268,171,17,456
701,22 August 2022,Shenzhen Bay,3176,264,21,3461,1476,584,23,2083
702,23 August 2022,Airport,4794,1213,320,6327,3550,654,269,4473
703,23 August 2022,Hong Kong-Zhuhai-Macao Bridge,319,23,40,382,259,164,29,452
704,23 August 2022,Shenzhen Bay,3174,315,22,3511,1488,622,47,2157
705,24 August 2022,Airport,4162,1094,293,5549,3349,1093,227,4669
706,24 August 2022,Hong Kong-Zhuhai-Macao Bridge,316,104,35,455,219,186,25,430
707,24 August 2022,Shenzhen Bay,3412,548,25,3985,1470,649,45,2164
708,25 August 2022,Airport,2789,662,268,3719,2684,876,228,3788
709,25 August 2022,Hong Kong-Zhuhai-Macao Bridge,90,7,13,110,146,145,15,306
710,25 August 2022,Shenzhen Bay,2389,446,30,2865,1326,574,48,1948
711,26 August 2022,Airport,4986,2439,521,7946,4393,1723,398,6514
712,26 August 2022,Hong Kong-Zhuhai-Macao Bridge,351,35,28,414,235,149,15,399
713,26 August 2022,Shenzhen Bay,3806,362,39,4207,1434,625,47,2106
714,27 August 2022,Airport,3873,1480,283,5636,3891,943,369,5203
715,27 August 2022,Hong Kong-Zhuhai-Macao Bridge,492,37,76,605,205,144,16,365
716,27 August 2022,Shenzhen Bay,4031,416,20,4467,1445,641,55,2141
717,28 August 2022,Airport,6121,1615,470,8206,4564,1278,319,6161
718,28 August 2022,Hong Kong-Zhuhai-Macao Bridge,703,38,28,769,217,155,15,387
719,28 August 2022,Shenzhen Bay,4180,332,21,4533,1347,621,42,2010
720,29 August 2022,Airport,2914,1228,283,4425,2776,571,291,3638
721,29 August 2022,Hong Kong-Zhuhai-Macao Bridge,552,25,30,607,188,185,19,392
722,29 August 2022,Shenzhen Bay,3663,450,31,4144,1366,626,38,2030
723,30 August 2022,Airport,3780,1785,425,5990,3959,1238,339,5536
724,30 August 2022,Hong Kong-Zhuhai-Macao Bridge,498,41,24,563,197,178,25,400
725,30 August 2022,Shenzhen Bay,3533,521,20,4074,1439,643,51,2133
726,31 August 2022,Airport,3215,1302,302,4819,3088,997,286,4371
727,31 August 2022,Hong Kong-Zhuhai-Macao Bridge,552,29,22,603,209,166,18,393
728,31 August 2022,Shenzhen Bay,3472,486,26,3984,1409,585,51,2045
729,1 September 2022,Airport,4258,1488,422,6168,3775,1154,315,5244
730,1 September 2022,Hong Kong-Zhuhai-Macao Bridge,333,28,39,400,243,194,15,452
731,1 September 2022,Shenzhen Bay,3404,348,37,3789,1301,524,28,1853
732,2 September 2022,Airport,3596,1602,500,5698,4753,1430,454,6637
733,2 September 2022,Hong Kong-Zhuhai-Macao Bridge,303,41,36,380,226,208,20,454
734,2 September 2022,Shenzhen Bay,2907,287,38,3232,1277,536,51,1864
735,3 September 2022,Airport,3196,1385,362,4943,4833,1089,395,6317
736,3 September 2022,Hong Kong-Zhuhai-Macao Bridge,419,48,71,538,227,207,17,451
737,3 September 2022,Shenzhen Bay,2781,307,25,3113,1358,524,49,1931
738,4 September 2022,Airport,4859,1654,417,6930,5415,1424,369,7208
739,4 September 2022,Hong Kong-Zhuhai-Macao Bridge,531,60,32,623,181,216,19,416
740,4 September 2022,Shenzhen Bay,2478,254,25,2757,1318,549,52,1919
741,5 September 2022,Airport,2593,1193,319,4105,3003,851,262,4116
742,5 September 2022,Hong Kong-Zhuhai-Macao Bridge,274,67,39,380,225,228,11,464
743,5 September 2022,Shenzhen Bay,1566,181,28,1775,1227,506,52,1785
744,6 September 2022,Airport,3878,1906,431,6215,4129,1350,345,5824
745,6 September 2022,Hong Kong-Zhuhai-Macao Bridge,222,40,44,306,187,198,20,405
746,6 September 2022,Shenzhen Bay,1358,236,17,1611,1198,484,24,1706
747,7 September 2022,Airport,3029,1367,365,4761,3281,975,346,4602
748,7 September 2022,Hong Kong-Zhuhai-Macao Bridge,198,41,53,292,174,199,25,398
749,7 September 2022,Shenzhen Bay,1175,191,14,1380,1038,433,39,1510
750,8 September 2022,Airport,3274,1349,447,5070,3008,1214,248,4470
751,8 September 2022,Hong Kong-Zhuhai-Macao Bridge,228,54,46,328,144,190,25,359
752,8 September 2022,Shenzhen Bay,1268,254,23,1545,1107,433,27,1567
753,9 September 2022,Airport,3773,1759,483,6015,4630,1437,412,6479
754,9 September 2022,Hong Kong-Zhuhai-Macao Bridge,221,66,29,316,143,222,31,396
755,9 September 2022,Shenzhen Bay,1339,211,21,1571,1110,487,38,1635
756,10 September 2022,Airport,2439,1189,316,3944,3856,935,346,5137
757,10 September 2022,Hong Kong-Zhuhai-Macao Bridge,146,41,71,258,131,182,18,331
758,10 September 2022,Shenzhen Bay,787,181,23,991,1020,531,29,1580
759,11 September 2022,Airport,4219,1447,452,6118,4860,1633,427,6920
760,11 September 2022,Hong Kong-Zhuhai-Macao Bridge,251,44,24,319,193,180,16,389
761,11 September 2022,Shenzhen Bay,1688,299,20,2007,892,434,33,1359
762,12 September 2022,Airport,2750,1367,379,4496,3397,852,218,4467
763,12 September 2022,Hong Kong-Zhuhai-Macao Bridge,301,62,25,388,223,213,20,456
764,12 September 2022,Shenzhen Bay,2122,330,20,2472,756,365,34,1155
765,13 September 2022,Airport,3542,1210,416,5168,4114,1430,290,5834
766,13 September 2022,Hong Kong-Zhuhai-Macao Bridge,236,49,27,312,220,167,20,407
767,13 September 2022,Shenzhen Bay,1510,289,13,1812,927,347,34,1308
768,14 September 2022,Airport,2752,1494,334,4580,3097,946,320,4363
769,14 September 2022,Hong Kong-Zhuhai-Macao Bridge,182,53,35,270,228,171,23,422
770,14 September 2022,Shenzhen Bay,1350,260,24,1634,774,353,29,1156
771,15 September 2022,Airport,3717,1242,502,5461,3529,1388,283,5200
772,15 September 2022,Hong Kong-Zhuhai-Macao Bridge,202,61,24,287,226,189,20,435
773,15 September 2022,Shenzhen Bay,1544,268,24,1836,943,332,31,1306
774,16 September 2022,Airport,3439,1504,492,5435,4675,1631,470,6776
775,16 September 2022,Hong Kong-Zhuhai-Macao Bridge,165,73,52,290,256,176,17,449
776,16 September 2022,Shenzhen Bay,1289,331,26,1646,782,309,40,1131
777,17 September 2022,Airport,2918,1081,336,4335,4437,921,442,5800
778,17 September 2022,Hong Kong-Zhuhai-Macao Bridge,180,58,93,331,176,181,26,383
779,17 September 2022,Shenzhen Bay,1391,354,33,1778,959,349,24,1332
780,18 September 2022,Airport,4767,1303,439,6509,4840,1531,425,6796
781,18 September 2022,Hong Kong-Zhuhai-Macao Bridge,241,64,46,351,165,184,29,378
782,18 September 2022,Shenzhen Bay,1790,302,17,2109,1018,335,20,1373
783,19 September 2022,Airport,2509,1318,325,4152,3057,937,251,4245
784,19 September 2022,Hong Kong-Zhuhai-Macao Bridge,173,63,39,275,196,157,19,372
785,19 September 2022,Shenzhen Bay,1176,312,21,1509,976,317,34,1327
786,20 September 2022,Airport,3557,1406,427,5390,3981,1480,396,5857
787,20 September 2022,Hong Kong-Zhuhai-Macao Bridge,165,48,34,247,210,144,25,379
788,20 September 2022,Shenzhen Bay,1415,263,20,1698,1095,320,32,1447
789,21 September 2022,Airport,2832,1645,344,4821,3189,1031,333,4553
790,21 September 2022,Hong Kong-Zhuhai-Macao Bridge,162,55,35,252,193,162,20,375
791,21 September 2022,Shenzhen Bay,1317,305,20,1642,1130,333,22,1485
792,22 September 2022,Airport,3492,1194,432,5118,3057,1154,303,4514
793,22 September 2022,Hong Kong-Zhuhai-Macao Bridge,127,50,33,210,187,180,20,387
794,22 September 2022,Shenzhen Bay,1117,240,27,1384,1152,359,34,1545
795,23 September 2022,Airport,3345,1113,433,4891,4488,1563,455,6506
796,23 September 2022,Hong Kong-Zhuhai-Macao Bridge,144,68,39,251,202,142,18,362
797,23 September 2022,Shenzhen Bay,1330,293,25,1648,1243,343,27,1613
798,24 September 2022,Airport,2416,1125,293,3834,3695,906,342,4943
799,24 September 2022,Hong Kong-Zhuhai-Macao Bridge,143,41,59,243,152,157,20,329
800,24 September 2022,Shenzhen Bay,1401,341,24,1766,1466,399,36,1901
801,25 September 2022,Airport,3667,1242,347,5256,4946,1402,510,6858
802,25 September 2022,Hong Kong-Zhuhai-Macao Bridge,196,46,28,270,164,176,25,365
803,25 September 2022,Shenzhen Bay,1593,297,23,1913,1234,391,26,1651
804,26 September 2022,Airport,2921,1308,298,4527,3400,694,330,4424
805,26 September 2022,Hong Kong-Zhuhai-Macao Bridge,169,38,24,231,159,173,27,359
806,26 September 2022,Shenzhen Bay,1426,278,20,1724,1192,382,28,1602
807,27 September 2022,Airport,3893,1196,460,5549,4408,1302,413,6123
808,27 September 2022,Hong Kong-Zhuhai-Macao Bridge,176,43,39,258,208,153,19,380
809,27 September 2022,Shenzhen Bay,1450,285,16,1751,1238,377,25,1640
810,28 September 2022,Airport,3292,1371,480,5143,4174,1035,431,5640
811,28 September 2022,Hong Kong-Zhuhai-Macao Bridge,195,44,38,277,191,145,23,359
812,28 September 2022,Shenzhen Bay,1787,267,40,2094,1227,288,26,1541
813,29 September 2022,Airport,3799,1115,550,5464,4422,1169,441,6032
814,29 September 2022,Hong Kong-Zhuhai-Macao Bridge,202,43,30,275,192,136,30,358
815,29 September 2022,Shenzhen Bay,1759,339,35,2133,1212,340,23,1575
816,30 September 2022,Airport,4031,1432,645,6108,7252,1478,534,9264
817,30 September 2022,Hong Kong-Zhuhai-Macao Bridge,228,31,26,285,207,94,19,320
818,30 September 2022,Shenzhen Bay,2098,363,53,2514,1145,351,34,1530
